BIOLOGICAL_REPLICATE_ID	no-data
CONTACT_LAB	Philip Rosentiel
CONTACT_PERSON	Anupam Sinha(a.sinha@ikmb.uni-kiel.de)
EXPERIMENT_DATE	no-data
EXPERIMENT_ID	53_Mf05_LPFi_Ct_snRNA_K_1_emd.tsv
EXPERIMENT_TYPE	RNA-Seq
EXTRACTION_PROTOCOL	no-data
EXTRACTION_PROTOCOL_STARTING_NR_CELLS	no-data
FULL_LENGTH_PROTOCOL_LINK	no-data
LIBRARY_GENERATION_cDNA_FRAGMENTATION	according to Illumina TruSeq stranded smallRNA protocol
LIBRARY_GENERATION_FRAGMENT_SIZE_SELECTION	145 bp-160 bp
LIBRARY_GENERATION_INITIAL_INPUT_QNTY	660ng total RNA
LIBRARY_GENERATION_PCR_F_PRIMER_SEQUENCE	5'AATGATACGGCGACCACCGAGATCTACACTCTTTCCCTACACGACGCTCTTCCGATCT
LIBRARY_GENERATION_PCR_NUMBER_CYCLES	11
LIBRARY_GENERATION_PCR_POLYMERASE_TYPE	From mastermix of TruSeq smallRNA kit
LIBRARY_GENERATION_PCR_PRIMER_CONC	no-data
LIBRARY_GENERATION_PCR_PRODUCT_ISOLATION_PROTOCOL	Gel Electrophoresis (according to Illumina TruSeq stranded smallRNA protocol)
LIBRARY_GENERATION_PCR_PRODUCT_LENGTH	113
LIBRARY_GENERATION_PCR_R_PRIMER_SEQUENCE	5'-GATCGGAAGAGCACACGTCTGAACTCCAGTCACATCACGATCTCGTATGCCGTCTTCTGCTTG
LIBRARY_GENERATION_PCR_TEMPLATE_CONC	0
LIBRARY_GENERATION_PCR_THERMOCYCLING_PROGRAM	"30"" 98°C. (10"" 98°C, 30"" 60°C, 15"" 72°C) 11 cycles, 10' 72°C, Hold at 4°C"
LIBRARY_GENERATION_PROTOCOL	IlluminaTruSeq small RNA Sample Preparation Guide (Part # 15004197 Rev. C)
RNA_cDNA_PREPARATION_INITIAL_RNA_QNTY	1µg total RNA
RNA_cDNA_PREPARATION_PCR_NUMBER_CYCLES	0
RNA_cDNA_PREPARATION_REVERSE_TRANSCRIPTION_PROTOCOL	according to Illumina TruSeq stranded smallRNA protocol
RNA_EXTRACTION_PROTOCOL	Trizol (Life Technoligies Cat. No. 15596-018)
RNA_EXTRACTION_PROTOCOL_FRAGMENTATION	0
RNA_PREPARATION_3'_RNA_ADAPTER_LIGATION_PROTOCOL	no-data
RNA_PREPARATION_3'_RNA_ADAPTER_SEQUENCE	according to Illumina TruSeq stranded smallRNA protocol
RNA_PREPARATION_5'_DEPHOSPHORYLATION	according to Illumina TruSeq stranded smallRNA protocol
RNA_PREPARATION_5'_PHOSPHORYLATION	according to Illumina TruSeq stranded smallRNA protocol
RNA_PREPARATION_5'_RNA_ADAPTER_LIGATION_PROTOCOL	according to Illumina TruSeq stranded smallRNA protocol
RNA_PREPARATION_5'_RNA_ADAPTER_SEQUENCE	according to Illumina TruSeq stranded smallRNA protocol
RNA_PREPARATION_FRAGMENT_SIZE_RANGE	0
RNA_PREPARATION_INITIAL_QNTY	500ng total RNA
RNA_PREPARATION_REVERSE_TRANSCRIPTION_PRIMER_SEQUENCE	according to Illumina TruSeq stranded smallRNA protocol
RNA_PREPARATION_REVERSE_TRANSCRIPTION_PROTOCOL	according to Illumina TruSeq stranded smallRNA protocol
RNA_PROTOCOL_ENRICHMENT	miRNA
SAMPLE_ID	53_Mf05_LPFi_Ct
SEQUENCING_CHEMISTRY_VERSION	TruSeq 50 cycle kit v3
SEQUENCING_CLUSTER_GENERATION_KIT_VERSION	SR TruSeq Cluster Kit v3
SEQUENCING_CONTROL_SOFTWARE_VERSION	HCS 2.0.12.0 / RTA 1.17.21.3 / Recipe Fragment 1.3.61.0
SEQUENCING_CYCLES	1x51
SEQUENCING_DATE	12/02/2014
SEQUENCING_LANE	2
SEQUENCING_PE_TYPE	0
SEQUENCING_PLATFORM	Illumina HiSeq 2500
SEQUENCING_PLATFORM_VERSION	2000
SEQUENCING_PROCESSING_SOFTWARE_VERSION	CASAVA 1.8.2
SEQUENCING_RUN_TYPE	Multiplexed SR 1x51 + 6 Index
TECHNICAL_REPLICATE_ID	1
ChromatinAccessibility_CHROMATIN_AMOUNT	no-data
ChromatinAccessibility_CHROMATIN_STATUS	no-data
ChromatinAccessibility_ENZYME	no-data
ChromatinAccessibility_ENZYME_AMOUNT	no-data
ChromatinAccessibility_ENZYME_LOT	no-data
ChromatinAccessibility_ENZYME_PROVIDER	no-data
ChromatinAccessibility_METHOD	no-data
ChromatinAccessibility_PROTOCOL	no-data
EXTRACTION_PROTOCOL_SONICATION_FRAGMENT_SIZE_RANGE	no-data
LIBRARY_GENERATION_ADAPTOR_LIGATION_PROTOCOL	no-data
LIBRARY_GENERATION_ADAPTOR_SEQUENCE	no-data
CHIP_ANTIBODY	no-data
CHIP_ANTIBODY_CATALOG	no-data
CHIP_ANTIBODY_LOT	no-data
CHIP_ANTIBODY_PROVIDER	no-data
CHIP_PROTOCOL	no-data
CHIP_PROTOCOL_ANTIBODY_AMOUNT	no-data
CHIP_PROTOCOL_BEAD_AMOUNT	no-data
CHIP_PROTOCOL_BEAD_TYPE	no-data
CHIP_PROTOCOL_CHROMATIN_AMOUNT	no-data
CHIP_PROTOCOL_DURATION_CROSSLINKING	no-data
CHIP_PROTOCOL_IPSTAR_CONDITIONS	no-data
CHIP_PROTOCOL_PERC_CH2O_CROSSLINKING	no-data
CHIP_PROTOCOL_SHEARING_CYCLES	no-data
CHIP_PROTOCOL_SHEARING_FREQUENCY	no-data
CHIP_PROTOCOL_SHEARING_METHOD	no-data
BISULFITE_CONVERSION_PROTOCOL	no-data
DNA_PREPARATION_FRAGMENT_SIZE_RANGE	no-data
DNA_PREPARATION_INITIAL_DNA_QNTY	no-data
EXTRACTION_PROTOCOL_SONICATION_CYCLES	no-data
EXTRACTION_PROTOCOL_TYPE_OF_SONICATOR	no-data
SEQUENCING_FC_ID	no-data
