EXPERIMENT_ID	51_Hf03_BlCM_Ct_WGBS_S_1
SAMPLE_ID	51_Hf03_BlCM_Ct
TECHNICAL_REPLICATE_ID	1
BIOLOGICAL_REPLICATE_ID	1
CONTACT_PERSON	Gilles Gasparoni, gillesgasparoni@gmail.com
CONTACT_LAB	Walter
EXPERIMENT_DATE	2014-10-06
EXPERIMENT_TYPE	DNA Methylation
EXTRACTION_PROTOCOL	PCI
EXTRACTION_PROTOCOL_STARTING_NR_CELLS	0.5x10^6
EXTRACTION_PROTOCOL_SONICATION_FRAGMENT_SIZE_RANGE	100-500
BISULFITE_CONVERSION_PROTOCOL	Zymo EZ-DNA methylation-Gold
LIBRARY_GENERATION_ADAPTOR_LIGATION_PROTOCOL	Illumina TruSeq PCR free library preparation
LIBRARY_GENERATION_ADAPTOR_SEQUENCE	GCCAAT
LIBRARY_GENERATION_PROTOCOL	Illumina TruSeq PCR free library preparation
LIBRARY_GENERATION_INITIAL_INPUT_QNTY	2000 ng
LIBRARY_GENERATION_PCR_F_PRIMER_SEQUENCE	AATGATACGGCGACCACCGAGATCTACAC
LIBRARY_GENERATION_PCR_NUMBER_CYCLES	9
LIBRARY_GENERATION_PCR_POLYMERASE_TYPE	Qiagen HotStar Taq
LIBRARY_GENERATION_PCR_PRIMER_CONC	200 nM
LIBRARY_GENERATION_PCR_PRODUCT_ISOLATION_PROTOCOL	Ampure Beads XP
LIBRARY_GENERATION_PCR_R_PRIMER_SEQUENCE	CAAGCAGAAGACGGCATACGAGAT
LIBRARY_GENERATION_PCR_TEMPLATE_CONC	23.5
LIBRARY_GENERATION_PCR_THERMOCYCLING_PROGRAM	15m @ 95C, 9*(30s @ 95°C, 30s @ 60°C, 1m @ 72°C), 7m @ 72°C, hold at 4°C
LIBRARY_GENERATION_PCR_PRODUCT_LENGTH	450
LIBRARY_GENERATION_FRAGMENT_SIZE_SELECTION	200-500
LIBRARY_GENERATION_cDNA_FRAGMENTATION	Bioruptor NGS
BIOMATERIAL_PROVIDER	Julia Polansky-Biskup
BIOMATERIAL_TYPE	primary cell
CELL_TYPE	central memory CD4-positive, alpha-beta T cell
COMMENT	age is mean of pool
DEEP_SAMPLE_ID	51_Hf03_BlCM_Ct
DISEASE	healthy
DONOR_AGE	45
DONOR_HEALTH_STATUS	healthy
DONOR_ID	51_Hf03
DONOR_SEX	female
MARKERS	CD3+ CD4+ CD25neg CD45-RAneg CCR7+
ORGANISM	Homo sapiens
POOL	yes
biosource_name	central memory CD4-positive, alpha-beta T cell
source	DEEP
epigenetic_mark	DNA Methylation
data_type	peaks
genome	hs37d5
experiment	51_Hf03_BlCM_Ct_WGBS_S_1.MCSv3.20150424.GRCh37.cpg.filtered.CG.bed
technique	WGBS
DONOR_AGE_UNIT	year
TISSUE_TYPE	blood
