EXPERIMENT_TYPE	smallRNA
CONTACT_PERSON	Madlen Sohn (madlen.sohn@mdc-berlin.de)
CONTACT_LAB	MDC
SAMPLE_ID	51_Hf05_BlTA_Ct
EXPERIMENT_DATE	04/01/15
EXPERIMENT_ID	51_Hf05_BlTA_Ct_snRNA_M_1
TECHNICAL_REPLICATE_ID	0
FULL_LENGTH_PROTOCOL_LINK	http://supportres.illumina.com/documents/documentation/chemistry_documentation/samplepreps_truseq/truseqsmallrna/truseq_smallrna_sampleprep_guide_15004197_e.pdf
BIOLOGICAL_REPLICATE_ID	0
EXTRACTION_PROTOCOL	Trizol + Qiagen MiRNeasy Micro
LIBRARY_GENERATION_PROTOCOL	Ilumina TrueSeq
LIBRARY_GENERATION_PCR_F_PRIMER_SEQUENCE	5'GUUCAGAGUUCUACAGUCCGACGAUC
LIBRARY_GENERATION_PCR_R_PRIMER_SEQUENCE	5' CAAGCAGAAGACGGCATACGAGAT CAGATC GTGACTGGAGTTCCTTGGCACCCGAGAATTCCA
LIBRARY_GENERATION_PCR_NUMBER_CYCLES	15
LIBRARY_GENERATION_PCR_POLYMERASE_TYPE	From mastermix of TruSeq smallRNA kit
LIBRARY_GENERATION_PCR_THERMOCYCLING_PROGRAM	30"" 98degC, [10"" 98degC, 30"" 60degC, 15"" 72degC] 18 cycles, 10' 72degC, hold 4degC
LIBRARY_GENERATION_PCR_TEMPLATE_CONC	800ng total RNA
LIBRARY_GENERATION_PCR_PRODUCT_ISOLATION_PROTOCOL	Gel.excision, 145-160bp fraction
LIBRARY_GENERATION_PCR_PRODUCT_LENGTH	144bp
LIBRARY_GENERATION_FRAGMENT_SIZE_SELECTION	144bp
SEQUENCING_PLATFORM	Illumina HiSeq
SEQUENCING_PLATFORM_VERSION	2000
SEQUENCING_CYCLES	51bp
SEQUENCING_PE_TYPE	Single-end
SEQUENCING_LANE	8
SEQUENCING_DATE	04/08/15
SEQUENCING_RUN_TYPE	Multiplexed SR 1x51 + 7 Index
SEQUENCING_CHEMISTRY_VERSION	TruSeq 50 cycle kit v3
SEQUENCING_CLUSTER_GENERATION_KIT_VERSION	SR TruSeq Cluster Kit v3
SEQUENCING_PROCESSING_SOFTWARE_VERSION	bcl2fastq-1.8.4
SEQUENCING_CONTROL_SOFTWARE_VERSION	HCS 2.2.38 / RTA 1.18.61/ Recipe Fragment: 1.5.14.0
EXTRACTION_PROTOCOL_STARTING_NR_CELLS	UKN
LIBRARY_GENERATION_INITIAL_INPUT_QNTY	800ng total RNA
RNA_PROTOCOL_ENRICHMENT_	miRNA
RNA_cDNA_PREPARATION_INITIAL_RNA_QNTY	800ng total RNA
RNA_cDNA_PREPARATION_PCR_NUMBER_CYCLES	0
RNA_cDNA_PREPARATION_REVERSE_TRANSCRIPTION_PROTOCOL	50degC for 1h
RNA_EXTRACTION_PROTOCOL_	Trizol
RNA_PREPARATION_INITIAL_QNTY_	800ng total RNA
RNA_PREPARATION_3'_RNA_ADAPTER_LIGATION_PROTOCOL	according to Illumina TruSeq smallRNA protocol
RNA_PREPARATION_3'_RNA_ADAPTER_SEQUENCE	according to Illumina TruSeq smallRNA protocol
RNA_PREPARATION_5'_DEPHOSPHORYLATION	according to Illumina TruSeq smallRNA protocol
RNA_PREPARATION_5'_PHOSPHORYLATION	according to Illumina TruSeq smallRNA protocol
RNA_PREPARATION_5'_RNA_ADAPTER_LIGATION_PROTOCOL	according to Illumina TruSeq smallRNA protocol
RNA_PREPARATION_5'_RNA_ADAPTER_SEQUENCE	according to Illumina TruSeq smallRNA protocol
RNA_PREPARATION_REVERSE_TRANSCRIPTION_PRIMER_SEQUENCE	according to Illumina TruSeq smallRNA protocol
RNA_PREPARATION_REVERSE_TRANSCRIPTION_PROTOCOL	according to Illumina TruSeq smallRNA protocol
METADATA_TAG	METADATA_VALUE
