BIOLOGICAL_REPLICATE_ID	1
CONTACT_LAB	Walter
CONTACT_PERSON	Gilles Gasparoni, gillesgasparoni@gmail.com
EXPERIMENT_DATE	2013-12-03
EXPERIMENT_ID	51_Hf01_BlCM_Ct_NOMe_S_1_emd.tsv
EXPERIMENT_TYPE	NOMe
EXTRACTION_PROTOCOL	N/A
EXTRACTION_PROTOCOL_STARTING_NR_CELLS	3700000
FULL_LENGTH_PROTOCOL_LINK	no-data
LIBRARY_GENERATION_cDNA_FRAGMENTATION	Bioruptor NGS
LIBRARY_GENERATION_FRAGMENT_SIZE_SELECTION	200-500
LIBRARY_GENERATION_INITIAL_INPUT_QNTY	400 ng
LIBRARY_GENERATION_PCR_F_PRIMER_SEQUENCE	PCR Primer Cocktail (PPC)
LIBRARY_GENERATION_PCR_NUMBER_CYCLES	8
LIBRARY_GENERATION_PCR_POLYMERASE_TYPE	HotFire Pol (Solis BioDyne)
LIBRARY_GENERATION_PCR_PRIMER_CONC	5 ul of PPC
LIBRARY_GENERATION_PCR_PRODUCT_ISOLATION_PROTOCOL	Ampure Beads XP
LIBRARY_GENERATION_PCR_PRODUCT_LENGTH	400 bp
LIBRARY_GENERATION_PCR_R_PRIMER_SEQUENCE	PCR Primer Cocktail (PPC)
LIBRARY_GENERATION_PCR_TEMPLATE_CONC	10 ng/ul
LIBRARY_GENERATION_PCR_THERMOCYCLING_PROGRAM	15m @ 95°C, 8*(30s @ 96°C, 30s @ 65°C, 30s @ 72°C), 5m @ 72°C, hold at 4°C
LIBRARY_GENERATION_PROTOCOL	Illumina TruSeq SamplePrep v2
RNA_cDNA_PREPARATION_INITIAL_RNA_QNTY	no-data
RNA_cDNA_PREPARATION_PCR_NUMBER_CYCLES	no-data
RNA_cDNA_PREPARATION_REVERSE_TRANSCRIPTION_PROTOCOL	no-data
RNA_EXTRACTION_PROTOCOL	no-data
RNA_EXTRACTION_PROTOCOL_FRAGMENTATION	no-data
RNA_PREPARATION_3'_RNA_ADAPTER_LIGATION_PROTOCOL	no-data
RNA_PREPARATION_3'_RNA_ADAPTER_SEQUENCE	no-data
RNA_PREPARATION_5'_DEPHOSPHORYLATION	no-data
RNA_PREPARATION_5'_PHOSPHORYLATION	no-data
RNA_PREPARATION_5'_RNA_ADAPTER_LIGATION_PROTOCOL	no-data
RNA_PREPARATION_5'_RNA_ADAPTER_SEQUENCE	no-data
RNA_PREPARATION_FRAGMENT_SIZE_RANGE	no-data
RNA_PREPARATION_INITIAL_QNTY	no-data
RNA_PREPARATION_REVERSE_TRANSCRIPTION_PRIMER_SEQUENCE	no-data
RNA_PREPARATION_REVERSE_TRANSCRIPTION_PROTOCOL	no-data
RNA_PROTOCOL_ENRICHMENT	no-data
SAMPLE_ID	51_Hf01_BlCM_Ct
SEQUENCING_CHEMISTRY_VERSION	no-data
SEQUENCING_CLUSTER_GENERATION_KIT_VERSION	no-data
SEQUENCING_CONTROL_SOFTWARE_VERSION	no-data
SEQUENCING_CYCLES	no-data
SEQUENCING_DATE	no-data
SEQUENCING_LANE	no-data
SEQUENCING_PE_TYPE	no-data
SEQUENCING_PLATFORM	no-data
SEQUENCING_PLATFORM_VERSION	no-data
SEQUENCING_PROCESSING_SOFTWARE_VERSION	no-data
SEQUENCING_RUN_TYPE	no-data
TECHNICAL_REPLICATE_ID	1
ChromatinAccessibility_CHROMATIN_AMOUNT	500000
ChromatinAccessibility_CHROMATIN_STATUS	Fixed
ChromatinAccessibility_ENZYME	M. CviPI
ChromatinAccessibility_ENZYME_AMOUNT	80 U
ChromatinAccessibility_ENZYME_LOT	N/A
ChromatinAccessibility_ENZYME_PROVIDER	NEB
ChromatinAccessibility_METHOD	NOMe
ChromatinAccessibility_PROTOCOL	DEEP.NOMe.v1
EXTRACTION_PROTOCOL_SONICATION_FRAGMENT_SIZE_RANGE	100-500
LIBRARY_GENERATION_ADAPTOR_LIGATION_PROTOCOL	Illumina TruSeq SamplePrep v2
LIBRARY_GENERATION_ADAPTOR_SEQUENCE	CTTGTA,GCCAAT
CHIP_ANTIBODY	no-data
CHIP_ANTIBODY_CATALOG	no-data
CHIP_ANTIBODY_LOT	no-data
CHIP_ANTIBODY_PROVIDER	no-data
CHIP_PROTOCOL	no-data
CHIP_PROTOCOL_ANTIBODY_AMOUNT	no-data
CHIP_PROTOCOL_BEAD_AMOUNT	no-data
CHIP_PROTOCOL_BEAD_TYPE	no-data
CHIP_PROTOCOL_CHROMATIN_AMOUNT	no-data
CHIP_PROTOCOL_DURATION_CROSSLINKING	no-data
CHIP_PROTOCOL_IPSTAR_CONDITIONS	no-data
CHIP_PROTOCOL_PERC_CH2O_CROSSLINKING	no-data
CHIP_PROTOCOL_SHEARING_CYCLES	no-data
CHIP_PROTOCOL_SHEARING_FREQUENCY	no-data
CHIP_PROTOCOL_SHEARING_METHOD	no-data
BISULFITE_CONVERSION_PROTOCOL	Zymo EZ-DNA methylation-Gold
DNA_PREPARATION_FRAGMENT_SIZE_RANGE	no-data
DNA_PREPARATION_INITIAL_DNA_QNTY	no-data
EXTRACTION_PROTOCOL_SONICATION_CYCLES	no-data
EXTRACTION_PROTOCOL_TYPE_OF_SONICATOR	no-data
SEQUENCING_FC_ID	no-data
