EXPERIMENT_TYPE	ChIP-Seq
CONTACT_PERSON	Ulrike Riehle (riehle@ie-freiburg.mpg.de), Laura Arrigoni (arrigoni@ie-freiburg.mpg.de), Thomas Manke (manke@ie-freiburg.mpg.de)
CONTACT_LAB	MPI-IE Deep Sequencing
SAMPLE_ID	43_Hm01_BlMo_Ct
EXPERIMENT_DATE	Jul 13
EXPERIMENT_ID	43_Hm01_BlMo_Ct_Input_F_1
TECHNICAL_REPLICATE_ID	Rep1 / Rep2
FULL_LENGTH_PROTOCOL_LINK	[MISSING]
BIOLOGICAL_REPLICATE_ID	[MISSING]
EXTRACTION_PROTOCOL	TruChIP Chromatin Preparation Low Cell SDS (Covaris)
EXTRACTION_PROTOCOL_SONICATION_CYCLES	Duty Cycle: 5 , Peak Incident Power: 140 , Cycles per Burst: 200 , Processing Time: 25 min
EXTRACTION_PROTOCOL_TYPE_OF_SONICATOR	Covaris S220
DNA_PREPARATION_FRAGMENT_SIZE_RANGE	200-700bp
DNA_PREPARATION_INITIAL_DNA_QNTY	Rep 1: 33,0 ng/µl Rep_2:_18.04_ng/µl
CHIP_PROTOCOL	Auto Histone ChIP Kit (Diagenode). Decrosslink + RNase/Proteinase K treatment 30 min 37 degrees + 4 hrs 65 degrees. Purification with Qiagen MinElute kit
CHIP_PROTOCOL_CHROMATIN_AMOUNT	Rep 1: 33 ng DNA Rep_2:_18_ng_DNA
CHIP_ANTIBODY	no Ab
CHIP_ANTIBODY_CATALOG	no Ab
CHIP_ANTIBODY_LOT	no Ab
CHIP_ANTIBODY_PROVIDER	no Ab
CHIP_PROTOCOL_ANTIBODY_AMOUNT	no Ab
CHIP_PROTOCOL_BEAD_AMOUNT	no beads
CHIP_PROTOCOL_BEAD_TYPE	no beads
LIBRARY_GENERATION_PROTOCOL	NEBNext Ultra DNA Kit (NEB, E7370)
LIBRARY_GENERATION_ADAPTOR_SEQUENCE	NEBNext Adaptor for Illumina (NEB, E7335) 5´-/5Phos/GATCGGAAGAGCACACGTCTGAACTCCAGTC/ideoxyU/ACACTCTTTCCCTACACGACGCTCTTCCGATC*T-3´
LIBRARY_GENERATION_PCR_F_PRIMER_SEQUENCE	NEBNext Universal PCR Primer for Illumina (NEB, E7335) 5´-AATGATACGGCGACCACCGAGATCTACACTCTTTCCCTACACGACGCTCTTCCGATC*T-3´
LIBRARY_GENERATION_PCR_R_PRIMER_SEQUENCE	Rep1: NEBNext Index 6 Primer for Illumina (NEB, E7500) Rep1:_5´-CAAGCAGAAGACGGCATACGAGATCGATTGGCGTGACTGGAGTTCAGACGTGTGCTCTTCCGATC-s-T-3´ Rep2:_NEBNext_Index_15_Primer_for_Illumina_(NEB,_E7500) Rep2:_5´-CAAGCAGAAGACGGCATACGAGATCGTGACATGTGACTGGAGTTCAGACGTGTGCTCTTCCGATC-s-T-3´
LIBRARY_GENERATION_PCR_PRIMER_CONC	not given in the protocol (1µl of universal and 1 µl of index primer per 50 µl PCR reaction)
LIBRARY_GENERATION_PCR_NUMBER_CYCLES	10
LIBRARY_GENERATION_PCR_POLYMERASE_TYPE	NEBNext High Fidelity (NEB, E7370)
LIBRARY_GENERATION_PCR_THERMOCYCLING_PROGRAM	Initial Denaturation: 98°C for 30 sec; 10 cycles: 98°C for 10 sec, 65°C for 30 sec, 72°C for 30 sec; Final extension: 72°C for 5 min; Hold at 4°C
LIBRARY_GENERATION_PCR_TEMPLATE_CONC	Rep1: Prior to PCR not meassured, Starting amount for library preparation: 7.4 ng fragmented IP DNA Rep2:_Prior_to_PCR_not_meassured,_Starting_amount_for_library_preparation:_15_ng_fragmented_IP_DNA_
LIBRARY_GENERATION_PCR_PRODUCT_ISOLATION_PROTOCOL	Agencourt AMPure XP Beads (Beckman Coulter, A63881)
LIBRARY_GENERATION_PCR_PRODUCT_LENGTH	Fragment size distribution from 200 bp to 1000 bp, Peak fragment size: 300 bp
LIBRARY_GENERATION_FRAGMENT_SIZE_SELECTION	no size selection
SEQUENCING_PLATFORM	Illumina HiSeq
SEQUENCING_PLATFORM_VERSION	2500
SEQUENCING_CYCLES	2x50 bp, 7bp Index
SEQUENCING_PE_TYPE	paired end
SEQUENCING_LANE	Rep1: D265MACXX _Lane 7 and Lane 8 Rep2:_D265MACXX__Lane_1_-_Lane_8
SEQUENCING_FC_ID	D265MACXX
SEQUENCING_DATE	D265MACXX_2013_08_12
SEQUENCING_RUN_TYPE	multiplex paired end (2x50 bp, 7 bp Index)
SEQUENCING_CHEMISTRY_VERSION	TruSeq SBS Kit v3 - HS (50-cycles)
SEQUENCING_CLUSTER_GENERATION_KIT_VERSION	TruSeq PE Cluster Kit v3 - cBot - HS
SEQUENCING_PROCESSING_SOFTWARE_VERSION	CASAVA 1.8.3
SEQUENCING_CONTROL_SOFTWARE_VERSION	HCS 2.0.12.0 / RTA 1.17.21.3 / Recipe Fragment 1.3.61.0
