EXPERIMENT_TYPE	RNA-Seq
CONTACT_PERSON	Anupam Sinha(a.sinha@ikmb.uni-kiel.de)
CONTACT_LAB	Philip Rosentiel
SAMPLE_ID	41_Hf11_LiHe_St
EXPERIMENT_ID	41_Hf11_LiHe_St_mRNA_K_1
FULL_LENGTH_PROTOCOL_LINK	http://supportres.illumina.com/documents/documentation%5Cchemistry_documentation%5Csamplepreps_truseq%5Ctruseqstrandedmrna%5Ctruseq-stranded-mrna-sample-prep-guide-15031047-e.pdf
LIBRARY_GENERATION_PROTOCOL	Illumina TruSeq stranded mRNA (Part # 15031047 Rev. E)
LIBRARY_GENERATION_PCR_F_PRIMER_SEQUENCE	5'-AATGATACGGCGACCACCGAGATCTACACTCTTTCCCTACACGACGCTCTTCCGATCT
LIBRARY_GENERATION_PCR_R_PRIMER_SEQUENCE	5'-GATCGGAAGAGCACACGTCTGAACTCCAGTCACATCACGATCTCGTATGCCGTCTTCTGCTTG
LIBRARY_GENERATION_PCR_NUMBER_CYCLES	15
LIBRARY_GENERATION_PCR_POLYMERASE_TYPE	From mastermix of TruSeq stranded mRNA kit
LIBRARY_GENERATION_PCR_THERMOCYCLING_PROGRAM	30"" 98 deg C, [10"" 98 deg C, 30"" 60 deg C, 30"" 72 deg C] 15 cycles, 5' 72 deg C, hold 4 deg C
LIBRARY_GENERATION_PCR_TEMPLATE_CONC	500 ng total RNA
LIBRARY_GENERATION_PCR_PRODUCT_ISOLATION_PROTOCOL	AmpureXP beads
LIBRARY_GENERATION_PCR_PRODUCT_LENGTH	278
LIBRARY_GENERATION_FRAGMENT_SIZE_SELECTION	none
SEQUENCING_PLATFORM	Illumina HiSeq
SEQUENCING_PLATFORM_VERSION	2000
SEQUENCING_CYCLES	2x101
SEQUENCING_PE_TYPE	PAIRED END
SEQUENCING_LANE	7
SEQUENCING_DATE	03/03/2015
SEQUENCING_RUN_TYPE	Multiplexed PE 2x101 + 7 Index
SEQUENCING_CHEMISTRY_VERSION	TruSeq 200 cycle kit v3
SEQUENCING_CLUSTER_GENERATION_KIT_VERSION	PE TruSeq Cluster Kit v3
LIBRARY_GENERATION_INITIAL_INPUT_QNTY	500 ng total RNA
LIBRARY_GENERATION_cDNA_FRAGMENTATION	Full-length cDNA was sheared using fragmentation mix from TruSeq kit, 8' at 94 deg C
RNA_PREPARATION_3'_RNA_ADAPTER_SEQUENCE	according to Illumina TruSeq stranded mRNA protocol
RNA_PREPARATION_5'_DEPHOSPHORYLATION	according to Illumina TruSeq stranded mRNA protocol
RNA_PREPARATION_5'_PHOSPHORYLATION	according to Illumina TruSeq stranded mRNA protocol
RNA_PREPARATION_5'_RNA_ADAPTER_LIGATION_PROTOCOL	according to Illumina TruSeq stranded mRNA protocol
RNA_PREPARATION_5'_RNA_ADAPTER_SEQUENCE	according to Illumina TruSeq stranded mRNA protocol
RNA_PREPARATION_REVERSE_TRANSCRIPTION_PRIMER_SEQUENCE	according to Illumina TruSeq stranded mRNA protocol
RNA_PREPARATION_REVERSE_TRANSCRIPTION_PROTOCOL	according to Illumina TruSeq stranded mRNA protocol
TECHNICAL_REPLICATE_ID__1	[MISSING]
RNA_PREPARATION_3'_RNA	according to Illumina TruSeq stranded mRNA protocol
RNA_PROTOCOL_ENRICHMENT_________Poly-A_enriched_total_RNA	[MISSING]
RNA_cDNA_PREPARATION_INITIAL_RNA_QNTY___500_ng_total_RNA	[MISSING]
RNA_cDNA_PREPARATION_PCR_NUMBER_CYCLES__0	[MISSING]
RNA_cDNA_PREPARATION_REVERSE_TRANSCRIPTION_PROTOCOL_____according_to_Illumina_TruSeq_stranded_mRNA_protocol	[MISSING]
RNA_EXTRACTION_PROTOCOL_________Trizol_(Life_Technologies_Cat._No._15596-018)	[MISSING]
RNA_EXTRACTION_PROTOCOL_FRAGMENTATION___0	[MISSING]
RNA_PREPARATION_FRAGMENT_SIZE_RANGE_____0	[MISSING]
RNA_PREPARATION_INITIAL_QNTY____500_ng_total_RNA	[MISSING]
SEQUENCING_PROCESSING_SOFTWARE_VERSION__CASAVA_1.8.2	[MISSING]
SEQUENCING_CONTROL_SOFTWARE_VERSION_____HCS_2.0.12.0_/_RTA_1.17.21.3_/_Recipe_Fragment_1.3.61.0	[MISSING]
