BIOMATERIAL_PROVIDER	Klinikum MÃ¼nchen
BIOMATERIAL_TYPE	primary cell
COMMENT	[MISSING]
DEEP_SAMPLE_ID	41_Hm04_LiHe_St
DISEASE	healthy
DONOR_ETHNICITY	no-data
ORGANISM	Homo sapiens
STATUS	no-data
STRAIN	no-data
CELL_TYPE	hepatocyte
DONOR_AGE	71-80
DONOR_AGE_UNIT	year
DONOR_HEALTH_STATUS	intrahepatic metastasis
DONOR_ID	41_Hm04
DONOR_SEX	male
MARKERS	no-data
POOL	no
TISSUE_TYPE	liver
SORTING_PARAMETERS	no-data
COLLECTION_METHOD	no-data
TISSUE_DEPOT	no-data
