BIOMATERIAL_PROVIDER	Janvier Labs
BIOMATERIAL_TYPE	primary cell
COMMENT	no-data
DEEP_SAMPLE_ID	41_Mm15_LiHe_OS
DISEASE	obesity
DONOR_ETHNICITY	no-data
ORGANISM	Mus musculus
STATUS	steatosis
STRAIN	C57BL/6J
CELL_TYPE	hepatocyte
DONOR_AGE	13
DONOR_AGE_UNIT	weeks
DONOR_HEALTH_STATUS	[MISSING]
DONOR_ID	41_Mm15
DONOR_SEX	male
MARKERS	.
POOL	no
TISSUE_TYPE	no-data
SORTING_PARAMETERS	no-data
COLLECTION_METHOD	no-data
TISSUE_DEPOT	no-data
