BIOMATERIAL_PROVIDER	Janvier Labs
BIOMATERIAL_TYPE	primary cell
COMMENT	13 weeks
DEEP_SAMPLE_ID	41_Mm16_LiHe_OS
DISEASE	obesity
DONOR_ETHNICITY	no-data
ORGANISM	Mus musculus
STATUS	steatosis
STRAIN	C57BL/6J
CELL_TYPE	hepatocyte
DONOR_AGE	0
DONOR_AGE_UNIT	no-data
DONOR_HEALTH_STATUS	[MISSING]
DONOR_ID	41_Mm16
DONOR_SEX	male
MARKERS	[MISSING]
POOL	no
TISSUE_TYPE	no-data
SORTING_PARAMETERS	[MISSING]
COLLECTION_METHOD	no-data
TISSUE_DEPOT	no-data
