BIOMATERIAL_PROVIDER	Pharmazeutische Biologie, UDS, Saarbruecken / IfADo, Dortmund
BIOMATERIAL_TYPE	primary cell
COMMENT	controlled: p62 expression / F4/80 expression / Lipid content
DEEP_SAMPLE_ID	42_Mf05_LiHe_Sh
DISEASE	healthy
DONOR_ETHNICITY	no-data
ORGANISM	Mus musculus
STATUS	Steatohepatitis by LdC diet
STRAIN	DBA/2J / C57BL/6J (LT2+/p62-)
CELL_TYPE	hepatocyte
DONOR_AGE	9
DONOR_AGE_UNIT	weeks
DONOR_HEALTH_STATUS	no-data
DONOR_ID	42_Mf05
DONOR_SEX	female
MARKERS	none
POOL	no
TISSUE_TYPE	no-data
SORTING_PARAMETERS	none
COLLECTION_METHOD	no-data
TISSUE_DEPOT	no-data
