BIOMATERIAL_PROVIDER	Julia Polansky-Biskup, Alf Hamann, DRFZ
BIOMATERIAL_TYPE	primary cell
COMMENT	no-data
DEEP_SAMPLE_ID	51_Hf11_SFEM_RD
DISEASE	rheumatic disease
DONOR_ETHNICITY	no-data
ORGANISM	Homo sapiens
STATUS	no-data
STRAIN	no-data
CELL_TYPE	effector memory CD4-positive, alpha-beta T cell
DONOR_AGE	54
DONOR_AGE_UNIT	year
DONOR_HEALTH_STATUS	rheumatic disease
DONOR_ID	51_Hf11
DONOR_SEX	female
MARKERS	CD3+CD4+CD25-CD45RA-CCR7-
POOL	yes
TISSUE_TYPE	no-data
SORTING_PARAMETERS	no-data
COLLECTION_METHOD	no-data
TISSUE_DEPOT	no-data
