BIOMATERIAL_PROVIDER	Dong/Chang/Radbruch, Julia Polansky-Biskup, Alf Hamann, DRFZ
BIOMATERIAL_TYPE	primary cell
COMMENT	sorted from bone-marrow, CD69+
DEEP_SAMPLE_ID	51_Hf08_BmTM4_SP1
DISEASE	healthy
DONOR_ETHNICITY	no-data
ORGANISM	Homo sapiens
STATUS	no-data
STRAIN	no-data
CELL_TYPE	CD4-positive alpha-beta memory T cell
DONOR_AGE	61
DONOR_AGE_UNIT	year
DONOR_HEALTH_STATUS	healthy
DONOR_ID	51_Hf08
DONOR_SEX	female
MARKERS	CD3+, CD4+, CD45RA-, CD45RO+, CD69+
POOL	yes
TISSUE_TYPE	bone marrow
SORTING_PARAMETERS	no-data
COLLECTION_METHOD	no-data
TISSUE_DEPOT	no-data
