EXPERIMENT_ID	01_HepG2_LiHG_Ct1_WGBS_S_1
SAMPLE_ID	01_HepG2_LiHG_Ct1
TECHNICAL_REPLICATE_ID	1
BIOLOGICAL_REPLICATE_ID	1
CONTACT_PERSON	Gilles Gasparoni, gillesgasparoni@gmail.com
CONTACT_LAB	Walter
EXPERIMENT_DATE	2013-06-20
EXPERIMENT_TYPE	DNA Methylation
EXTRACTION_PROTOCOL	Sigma GenElute
EXTRACTION_PROTOCOL_STARTING_NR_CELLS	1x10^6
EXTRACTION_PROTOCOL_SONICATION_FRAGMENT_SIZE_RANGE	100-500
BISULFITE_CONVERSION_PROTOCOL	Zymo EZ-DNA methylation
LIBRARY_GENERATION_ADAPTOR_LIGATION_PROTOCOL	Illumina TruSeq SamplePrep v2
LIBRARY_GENERATION_ADAPTOR_SEQUENCE	CGATGT
LIBRARY_GENERATION_PROTOCOL	Illumina TruSeq SamplePrep v2
LIBRARY_GENERATION_INITIAL_INPUT_QNTY	1370 ng
LIBRARY_GENERATION_PCR_F_PRIMER_SEQUENCE	PCR Primer Cocktail (PPC)
LIBRARY_GENERATION_PCR_NUMBER_CYCLES	9
LIBRARY_GENERATION_PCR_POLYMERASE_TYPE	HotFire Pol (Solis BioDyne)
LIBRARY_GENERATION_PCR_PRIMER_CONC	5 µl of PPC
LIBRARY_GENERATION_PCR_PRODUCT_ISOLATION_PROTOCOL	Ampure Beads XP
LIBRARY_GENERATION_PCR_R_PRIMER_SEQUENCE	PCR Primer Cocktail (PPC)
LIBRARY_GENERATION_PCR_TEMPLATE_CONC	13.7 ng/µl
LIBRARY_GENERATION_PCR_THERMOCYCLING_PROGRAM	15m @ 95°C, 9*(30s @ 96°C, 30s @ 65°C, 30s @ 72°C), 5m @ 72°C, hold at 4°C
LIBRARY_GENERATION_PCR_PRODUCT_LENGTH	400
LIBRARY_GENERATION_FRAGMENT_SIZE_SELECTION	200-500
LIBRARY_GENERATION_cDNA_FRAGMENTATION	Bioruptor NGS
BIOMATERIAL_PROVIDER	ATCC
BIOMATERIAL_TYPE	cell line
CELL_TYPE	HepG2
COMMENT	-
DEEP_SAMPLE_ID	01_HepG2_LiHG_Ct1
DISEASE	Hepatocellular carcinoma
DONOR_AGE	15
DONOR_ETHNICITY	caucasian
DONOR_HEALTH_STATUS	hepatocarcinoma
DONOR_ID	HepG2
DONOR_SEX	male
MARKERS	none
ORGANISM	Homo sapiens
POOL	no
STATUS	untreated
biosource_name	HepG2
source	DEEP
epigenetic_mark	DNA Methylation
data_type	peaks
genome	hs37d5
experiment	01_HepG2_LiHG_Ct1_WGBS_S_1.MCSv3.20150424.GRCh37.cpg.filtered.CG.bed
technique	WGBS
DIFFERENTIATION_STATE	undifferentiated
LINE	HepG2
MEDIUM	DMEM + 10% FCS + 1% Pen/Strep
PASSAGE	15
SEX	male
